1111111111111
1E0000N0000C1
1110000C00001
1P00000C00011
1111111111111
