111111111111111111111111111
1P00000C11C1C1C1C10C1C101C1
111101111101000001011010101
11110110100001C111001000001
1C00011010111111C1101011011
1111010010110111010000010C1
111C01100000000101101111111
1C1101110111010000N000000C1
101100000011111111111111111
1000011010000000000000000E1
111111111111111111111111111